talk - говорить
and - и
prevalent - распространненый, общепринятый
eventually - в конечном счете
extend  - протягиватьс, вытягивать
departure - отъезд, уход, отклонение
distinguish - отличать, различать
perpetuate -увековечивать
domestic - внутрений,локальный, товары внутреннего производства
demand - требование, требовать, спрос 
blind - ослеплять
deserve - заслуживать, иметь право
pregnancy - беременность
retire - увольнять, ликвидировать 
gliding - скольжение
glid - скользить
faith - вера
decline - снижение, вера
weakening - ослабление
weaken - ослаблять 
tuple - картеж
convolve - скрутить
applicant - заявитель кондидат истец
biases - уклон смещать
assume - принимать, предполагать
designation - обозначение
pursuit - преследование, занятие, гонение(люди)
scatter - рассеиваться, рассеивать,сорить
stringent condition - строгие условия
broaden - расширять, расширяться
allowance - пособие
convolution - делать свертку
dimension - ращмеры
Adoption - внедрение, усыновление
fostering - создание, содействие
foster - содействовать
kinship - родство
convict - преступник,осужденный
guarantee - гарантия горантировать
adoptive parents - приемные родители
it’s to be hoped  - хотелось бы 
stride - шаг, шагать
homelessness - бездомность
reshaping - изменение
reshape - изменяться
mindset  -мышление
invent - изобретать
invite - приглашать
excite -волновать, стимулировать
breakthroughs - прорыв
purge - чистка,очищать, производить чистку
crisper - контейнер для овощей
crisper - свежий, хрустящий
frivolous - не серьезный
inventory systems - система учета запасов
viable products - жизнинеобходимые продукты
distraction -отвлечение отвлекающий маневр
procrastinate - откладывать
relief - облегчение рельеф
divergent - расходящийся, рассеивающий
hurry - спешка, спешить, торопиться
appreciate - ценить, оценивать
acquiescent - уступчивый
appear - казаться, появляться, представляться
job position - должность
to get a raise - получить повышение
argument- аргумент, спор
reach - добрался до куда-то
lost consciousness - потерял состояние
My loved ones /his loved ones  - своих 
span - промежуток,охватывать
impatience - нетерпение
exacerbate - усиливать
pervade - проникать
fast forwarded 
suppress - подавлять, заглушать
Most people try to suppress their impatience. -
jolt - толчок трясти встряхнуть
outburst - вспышка
to gain power over it
justify - оправдывать
pass - проход, переход, пас, передовать,пасовать
passable - проходимый
puffy - опухший, дутый
falsely evicted - ложно выселены
to yawn - зевать
to get rid off избавляться